
NO                      textures/north.xpm
SO       textures/south.xpm
WE textures/west.xpm
EA textures/east.xpm
F 220,100,1


C       250,30,1     


      1111111111111111111111111
11111111111111011101010010001
11000000110101011100000N00001
1000000000000000110000001000011111
111001000000001101010010000000001
100000100000000000000000000000001
1100100111011101111101111000111111
11110111 1110110 101111010001
                 111111011111


