NO ./textures/north.xpm\nSO ./textures/south.xpm\nWE ./textures/west.xpm\nEA ./textures/east.xpm\n\n\nF 220,100,0\nC 225,30,0\n\n\n        1111111111111S11111111111\n        1000000000110000000000001\n        1011000001110000000000001\n        \n
        1001000000000000000000001
111111111011000001110000000000001
100000000011000001110111111111111
11110111111111011100000010001 
11110111111111011101010010001
11000000110101011100000010001
10000000000000001100000010001
10000000000000001101010010001
1100000111010101111011110N0111
11110111 1110101 101111010001
11111111 1111111 111111111111
11110111




