
NO /mnt/nfs/homes/grannou/Cub3DMinusCortex/textures_solong/Kyubie42.xpm
SO /mnt/nfs/homes/grannou/Cub3DMinusCortex/textures_solong/Sakura42.xpm
WE /mnt/nfs/homes/grannou/Cub3DMinusCortex/textures_solong/Tori42.xpm
EA /mnt/nfs/homes/grannou/Cub3DMinusCortex/textures_solong/Tree42.xpm

F 220  ,100  , 0
C 225 ,  30  , 0

1111111111111        1111111111111111
1000000000001        1010000000000001
1000000000000        1010N00100000111
1000000000001111111111000000100000001
1000000000001        1000000000010001
1111111111111        1111111111111111