
NO ./textures_solong/Kyubie42.xpm
SO ./textures_solong/Sakura42.xpm
WE ./textures_solong/Tori42.xpm
EA ./textures_solong/Tree42.xpm

F 0  , 255 , 0
C 0 , 0 , 200

111111111111111111
1010000000000000000001
1010000100000100000011111
1010000000010000000001111
1000E00000010000000001
1111111111111111111111
