
NO /mnt/nfs/homes/grannou/Cub3DMinusCortex/textures_solong/Kyubie42.xpm
SO /mnt/nfs/homes/grannou/Cub3DMinusCortex/textures_solong/Sakura42.xpm
WE /mnt/nfs/homes/grannou/Cub3DMinusCortex/textures_solong/Tori42.xpm
EA /mnt/nfs/homes/grannou/Cub3DMinusCortex/textures_solong/Tree42.xpm

F 220  ,100  , 0
C 225 ,  30  , 0

1111111111111111
1010000000000001
0010000100000111
1010000N00010001
1000000000010001
1111111111111111